xxxxxxxxx
xxx00000x
xxx01000x
xxx1x1a0x
xx000axxx
xxa0100xx
xxxbx00xx
xc00b00xx
xxxxxxxxx