xxxxxxxx
xx0a000x
xx1bxm1x
xa00x1ax
x0x00b0x
x0xx000x
x000b00x
x000xxxx
xxxxxxxx