xxxxxxxx
xxxx000x
xxxx000x
xa0x100x
xa0a100x
x0x0b0mx
x10x01xx
xa0000xx
xxxxxxxx