xxxxxxxx
xaxxxxxx
xm1a0axx
x011xxxx
xx00a0xx
xx010a0x
xxx1000x
xxx0000x
xxxxxxxx